11111111111111
1C0000V0000001
100000E0P00001
11011100001111
10000000001111
11111111111111