1111111111111
100PV00000001
110011111VC01
1101C1111VC01
110011111VC01
1E0011C00C001
1111111111111