111111111
1000CEP11
100000001
111111111